................................
................................
................................
................................
................................
................................
................................
................................
................................
................................
................................
................................
................................
................................
................................
................................
..CCCCC........................V
11111116......................31
22222227......................42
22222227....P...B.............42
222222281111111116....3111111152
222222222222222227....4222222222
222222222222222227....4222222222
222222222222222227....4222222222
222222222222222227....4222222222
222222222222222227....4222222222

. = air
1 = grass
2 = dirt
3 = left_grass
4 = left_dirt
5 = upleft_dirt
6 = right_grass
7 = right_dirt
8 = upright_dirt
C = crate
P = player
B = bomb
V = vortex