.....................................
.....................................
.....................................
.....................................
.....................................
.....................................
.....................................
.....................................
.....................................
.....................................
.....................................
.....................................
.....................................
.....................................
.....................................
.....................................
..B..................................
116................................V.
227...............................311
227.BC.P..........................422
2281111116.....deeeeeef.....311111522
2222222227..................422222222
2222222227..................422222222
2222222227..................422222222
2222222227..................422222222
2222222227..................422222222

. = air
1 = grass
2 = dirt
3 = left_grass
4 = left_dirt
5 = upleft_dirt
6 = right_grass
7 = right_dirt
8 = upright_dirt
d = left_grass_slab
e = grass_slab
f = right_grass_slab
C = crate
P = player
B = bomb
V = vortex