................................
................................
................................
................................
................................
................................
................................
................................
................................
................................
................................
................................
................................
................................
................................
................................
..B.............................
116...........................V.
227.........................3111
227.BC.P....................4222
2281111116............3111115222
2222222227............4222222222
2222222227............4222222222
2222222227............4222222222
2222222227............4222222222
2222222227............4222222222

. = air
1 = grass
2 = dirt
3 = left_grass
4 = left_dirt
5 = upleft_dirt
6 = right_grass
7 = right_dirt
8 = upright_dirt
C = crate
P = player
B = bomb
V = vortex