................42227...........
................42227...........
................42227...........
................42227...........
................42227...........
................42227...........
................42227...........
................42227...........
................42227...........
................42227...........
................42227...........
................42227...........
................42227...........
................42227...........
................42227...........
..........B.....42227...........
.........BC.....42227...........
......31116.....abbbc.........V.
...P..42227.................3111
11111152227.................4222
22222222227............311115222
22222222227.......31111522222222
22222222227.......42222222222222
22222222227.......42222222222222
22222222227.......42222222222222
22222222227.......42222222222222

. = air
1 = grass
2 = dirt
3 = left_grass
4 = left_dirt
5 = upleft_dirt
6 = right_grass
7 = right_dirt
8 = upright_dirt
a = leftbottom_dirt
b = bottom_dirt
c = rightbottom_dirt
C = crate
P = player
B = bomb
V = vortex