................................
................................
................................
................................
................................
................................
................................
................................
................................
................................
................................
................................
................................
................................
....C.........................V.
....CC.......................311
....B36......................422
1111157...C......31116.......422
2222227..B36.....42227.......422
222222811157.....42227.......422
222222222227..P..422281111111522
22222222222816B31522222222222222
22222222222228152222222222222222
22222222222222222222222222222222
22222222222222222222222222222222
22222222222222222222222222222222

. = air
1 = grass
2 = dirt
3 = left_grass
4 = left_dirt
5 = upleft_dirt
6 = right_grass
7 = right_dirt
8 = upright_dirt
C = crate
P = player
B = bomb
V = vortex