7......427............427.....422
7......427............427.....422
7......427............427.....422
7......427............427.....422
7......427............427.....422
7......427............427.....422
7......427............427.....422
7......427............427.....422
7......427............427.....422
7......427............427.....422
7......427............427.....422
7......427............427.....422
7......427............427.....422
7......427......V.....427.....422
7......427............427.....422
7......427............427.....422
7......427............427.....422
7......abc............abcC....422
7.........C........C....BC....422
7.....deeeeef......deeeeef....422
7.............................422
7.....................C.......422
7......P..............C...3111522
7.C.B..C..B...............4222222
8111111111116......31111115222222
2222222222227......42222222222222

. = air
1 = grass
2 = dirt
3 = left_grass
4 = left_dirt
5 = upleft_dirt
6 = right_grass
7 = right_dirt
8 = upright_dirt
a = leftbottom_dirt
b = bottom_dirt
c = rightbottom_dirt
d = left_grass_slab
e = grass_slab
f = right_grass_slab
C = crate
P = player
B = bomb
V = vortex