...................47...........
...................47...........
...................47...........
...................47...........
...................47...........
...................47...........
...................47...........
...................47...........
...................47...........
...C...............47...........
..CCC..............47...........
11111116...........47........V..
22222227...........47.....311111
222222hc...........47.....422222
2222227..........B.47.....422222
2222227.........31157.....422222
2222227.........abbbc.....422222
2222227..C................422222
222222811116..............422222
222222222227..............422222
222222222227....P.........422222
22222222222816B3111111116.422222
2222222222222815222222227.422222
2222222222222222222222227.422222
2222222222222222222222227.422222
2222222222222222222222227B422222
22222222222222222222222281522222
22222222222222222222222222222222

. = air
1 = grass
2 = dirt
3 = left_grass
4 = left_dirt
5 = upleft_dirt
6 = right_grass
7 = right_dirt
8 = upright_dirt
a = leftbottom_dirt
b = bottom_dirt
c = rightbottom_dirt
h = downright_dirt
C = crate
P = player
B = bomb
V = vortex