.......................................
..BBBBBBBBBBBBBBBBBBBBBBBBBBBBBBBBBB...
..BBBBBBBBBBBBBBBBBBBBBBBBBBBBBBBBBB...
..BBBBBBBBBBBBBBBBBBBBBBBBBBBBBBBBBB...
..BBBBBBBBBBBBBBBBBBBBBBBBBBBBBBBBBB...
..BBBBBBBBBBBBBBBBBBBBBBBBBBBBBBBBBB...
..BBBBBBBBBBBBBBBBBBBBBBBBBBBBBBBBBB...
..BBBBBBBBBBBBBBBBBBBBBBBBBBBBBBBBBB...
..BBBBBBBBBBBBBBBBBBBBBBBBBBBBBBBBBB...
..BBBBBBBBBBBBBBBBBBBBBBBBBBBBBBBBBB...
..BBBBBBBBBBBBBBBBBBBBBBBBBBBBBBBBBB...
.......................................
.......................................
.....................................V.
....................................311
6...................................422
7...................................422
7.................31116.............422
7.......C.........42227.............422
7.P...31116.......42227......B......422
811111522281111111522281111111111111522
222222222222222222222222222222222222222
222222222222222222222222222222222222222
222222222222222222222222222222222222222
222222222222222222222222222222222222222
222222222222222222222222222222222222222

. = air
1 = grass
2 = dirt
3 = left_grass
4 = left_dirt
5 = upleft_dirt
6 = right_grass
7 = right_dirt
8 = upright_dirt
C = crate
P = player
B = bomb
V = vortex